C 225,30,0
NO                    ./Users/arabiai/Desktop/42_projects/Cube3D/textures/text.jpg
WE ./Users/arabiai/Desktop/42_projects/Cube3D/textures/windows.jpg
F 220,100,255
SO ./Users/arabiai/Desktop/42_projects/Cube3D/textures/saul.jpg
EA        ./Users/arabiai/Desktop/42_projects/Cube3D/textures/church.jpg


11111111111111111111111111111111
10000000001100000000000011111111
10110000011100000000000011111111
10001000000000000000000011111111
11111111001100001110000000000001
10000000011000001110101111111111
11110111111111011100000010001111
11110111111111011101010010001111
11000000110101011100000010111111
10000000000000001100000010011111
10000000000000001101010000001111
1100000111010101111101110N011111
11110111111101011101111010001111
11111111111111111111111111111111
