C 225,30,0
NO                    ./Users/arabiai/Desktop/42_projects/Cube3D/textures/text.jpg
WE ./Users/arabiai/Desktop/42_projects/Cube3D/textures/windows.jpg
F 220,100,255
SO ./Users/arabiai/Desktop/42_projects/Cube3D/textures/saul.jpg
EA        ./Users/arabiai/Desktop/42_projects/Cube3D/textures/church.jpg
        1111111111111111111111111
        1000000000110000000000001
        1011000001110000000000001
        1001000000000000000000001
111111111011000011100000000000011
100000000110000011101011111111111
11110111111111011100000010001
11110111111111011101010010001
11000000110101011100000010111
10000000000000001100000010011
10000000000000001101010010001
1100000111010101111101110N0111
11110111 1110101 101111010001
11111111 1111111 111111111111