C 225,30,0



NO                    ./USERS/ahmaymou/Desktop/c3d/textures/text.jpg
WE ./USERS/ahmaymou/Desktop/c3d/textures/windows.jpg




F 220,100,255




SO ./USERS/ahmaymou/Desktop/c3d/textures/saul.jpg
EA        ./USERS/ahmaymou/Desktop/c3d/textures/church.jpg
        1111111111111111111111111
        1000000000110000000000001
        1011000001110000000000001
        1001000000000000000000001
11111111101100001110000000000001
10000000011000001110101111111111          1  1
11110111111111011100000010001               101
11110111111111011101010010001     111   1  1101
11000000110101011100000010111               111
10000000000000001100000010011
10000000000000001101010010001
1100000111010101111101110N0111
11110111 1110101 101111010001
11111111 1111111 111111111111