C 225,30,0
NO                    /Users/arabiai/Desktop/42_projects/Cube3D/textures/text.jpg
WE /Users/arabiai/Desktop/42_projects/Cube3D/textures/windows.jpg
F 220,100,255
SO /Users/arabiai/Desktop/42_projects/Cube3D/textures/saul.jpg
EA        /Users/arabiai/Desktop/42_projects/Cube3D/textures/church.jpg

11111111111111111111111111111111111111111111111111
10000000001100000000000011100011111000000000001111
10110000011100000000000010001010111000000000001111
10010000000000000000000011111100111000000000001111
11111111101100001110000000000001111000000000001111
10000000011000001110101111111111111000000000001111
11110111111111011100000010001110111000000000001111
11110111111111011101010010001111011000000000001111
11000000110101011100000010111111011000000000001111
10000000000000001100000010011111011000000000001111
10000000000000001101010010001111011000000000001111
1100000111010101111101110N011111101000000000001111
11110111 1110101 101111010001111011000000000001111
11111111 1111111 111111111111111111111111111111111