C 10,10,10
NO                    /Users/arabiai/Desktop/Cube/textures/space0_1.xpm
WE /Users/arabiai/Desktop/Cube/textures/orange.xpm
F 50,50,54
SO /Users/arabiai/Desktop/Cube/textures/octopus.xpm
EA        /Users/arabiai/Desktop/Cube/textures/lwodo7.xpm

111111111111111111111111111111111111111111111111111111111111111111111111111111111111111111111111111111111111111111111111111111111111111111111111111111
100000000011000000000000111000111110000000000011111111111111111111111111111111111111111111111111111111111111111111111111111111111111111111111111111111
101100000111000000000000100010101110000000000011111111111111111111111111111111111111111111111111111111111111111111111111111111111111111111111111111111
100100000000000000000000111111001110000000000011111111111111111111111111111111111111111111111111111111111111111111111111111111111111111111111111111111
111111111011000011100000000000011110000000000011111111111111111111111111111111111111111111111111111111111111111111111111111111111111111111111111111111
100000000110000011101011111110000000000000000011111111111111111111111111111111111111111111111111111111111111111111111111111111111111111111111111111111
111101111111110111000000100011101110000000000011111111111111111111111111111111111111111111111111111111111111111111111111111111111111111111111111111111
111101111111110111010100100011110110000000000011111111111111111111111111111111111111111111111111111111111111111111111111111111111111111111111111111111
1100000011010101110000001011111101100000W0000011111111111111111111111111111111111111111111111111111111111111111111111111111111111111111111111111111111
100000000000000011000000100111110110000000000011111111111111111111111111111111111111111111111111111111111111111111111111111111111111111111111111111111
100000000000000011010100100011110110000000000011111111111111111111111111111111111111111111111111111111111111111111111111111111111111111111111111111111
110000011101010111110111000000000000000000000011111111111111111111111111111111111111111111111111111111111111111111111111111111111111111111111111111111
111101111111010111011110100011110110000000000011111111111111111111111111111111111111111111111111111111111111111111111111111111111111111111111111111111
111111111111111111111111111111111111111111111111111111111111111111111111111111111111111111111111111111111111111111111111111111111111111111111111111111
111111111111111111111111111111111111111111111111111111111111111111111111111111111111111111111111111111111111111111111111111111111111111111111111111111
100000000110000000000001110001111100000000000111111111111111111111111111111111111111111111111111111111111111111111111111111111111111111111111111111111
101100000111000000000000100010101110000000000011111111111111111111111111111111111111111111111111111111111111111111111111111111111111111111111111111111
100100000000000000000000111111001110000000000011111111111111111111111111111111111111111111111111111111111111111111111111111111111111111111111111111111
111111111011000011100000000000011110000000000011111111111111111111111111111111111111111111111111111111111111111111111111111111111111111111111111111111
100000000110000011101011111111111110000000000011111111111111111111111111111111111111111111111111111111111111111111111111111111111111111111111111111111
111101111111110111000000100011101110000000000011111111111111111111111111111111111111111111111111111111111111111111111111111111111111111111111111111111
111101111111110111010100100011110110000000000011111111111111111111111111111111111111111111111111111111111111111111111111111111111111111111111111111111
110000001101010111000000101111110110000000000011111111111111111111111111111111111111111111111111111111111111111111111111111111111111111111111111111111
100000000000000011000000100111110110000000000011111111111111111111111111111111111111111111111111111111111111111111111111111111111111111111111111111111
100000000000000011010100100011110110000000000011111111111111111111111111111111111111111111111111111111111111111111111111111111111111111111111111111111
110000011101010111110111000111111010000000000011111111111111111111111111111111111111111111111111111111111111111111111111111111111111111111111111111111
11110111 1110101 1011110100011110110000000000011111111111111111111111111111111111111111111111111111111111111111111111111111111111111111111111111111111
11111111 1111111 1111111111111111111111111111111111111111111111111111111111111111111111111111111111111111111111111111111111111111111111111111111111111